U.N. <WSD>group</WSD> drafts plan to reduce emissions	group.n.03:00
U.N. group drafts <WSD>plan</WSD> to reduce emissions	plan.n.09:00
U.N. group drafts plan to reduce <WSD>emissions</WSD>	emission.n.27:00
The U.N.-sponsored <WSD>climate</WSD> conference -- characterized so far by unruly posturing and mutual recriminations -- gained renewed focus Friday with the release of a document outlining ambitious greenhouse-gas reductions over the next 40 years , with industrialized nations shouldering most of the burden in the near term .	climate.n.26:00
The U.N.-sponsored climate <WSD>conference</WSD> -- characterized so far by unruly posturing and mutual recriminations -- gained renewed focus Friday with the release of a document outlining ambitious greenhouse-gas reductions over the next 40 years , with industrialized nations shouldering most of the burden in the near term .	conference.n.14:00
The U.N.-sponsored climate conference -- characterized so far by unruly <WSD>posturing</WSD> and mutual recriminations -- gained renewed focus Friday with the release of a document outlining ambitious greenhouse-gas reductions over the next 40 years , with industrialized nations shouldering most of the burden in the near term .	posturing.n.07:00
The U.N.-sponsored climate conference -- characterized so far by unruly posturing and mutual <WSD>recriminations</WSD> -- gained renewed focus Friday with the release of a document outlining ambitious greenhouse-gas reductions over the next 40 years , with industrialized nations shouldering most of the burden in the near term .	recrimination.n.10:00
The U.N.-sponsored climate conference -- characterized so far by unruly posturing and mutual recriminations -- gained renewed <WSD>focus</WSD> Friday with the release of a document outlining ambitious greenhouse-gas reductions over the next 40 years , with industrialized nations shouldering most of the burden in the near term .	focus.n.09:00
The U.N.-sponsored climate conference -- characterized so far by unruly posturing and mutual recriminations -- gained renewed focus <WSD>Friday</WSD> with the release of a document outlining ambitious greenhouse-gas reductions over the next 40 years , with industrialized nations shouldering most of the burden in the near term .	friday.n.28:00
The U.N.-sponsored climate conference -- characterized so far by unruly posturing and mutual recriminations -- gained renewed focus Friday with the <WSD>release</WSD> of a document outlining ambitious greenhouse-gas reductions over the next 40 years , with industrialized nations shouldering most of the burden in the near term .	release.n.22:00
The U.N.-sponsored climate conference -- characterized so far by unruly posturing and mutual recriminations -- gained renewed focus Friday with the release of a <WSD>document</WSD> outlining ambitious greenhouse-gas reductions over the next 40 years , with industrialized nations shouldering most of the burden in the near term .	document.n.10:00
The U.N.-sponsored climate conference -- characterized so far by unruly posturing and mutual recriminations -- gained renewed focus Friday with the release of a document outlining ambitious greenhouse-gas <WSD>reductions</WSD> over the next 40 years , with industrialized nations shouldering most of the burden in the near term .	reduction.n.04:00
The U.N.-sponsored climate conference -- characterized so far by unruly posturing and mutual recriminations -- gained renewed focus Friday with the release of a document outlining ambitious greenhouse-gas reductions over the next 40 <WSD>years</WSD> , with industrialized nations shouldering most of the burden in the near term .	year.n.28:01
The U.N.-sponsored climate conference -- characterized so far by unruly posturing and mutual recriminations -- gained renewed focus Friday with the release of a document outlining ambitious greenhouse-gas reductions over the next 40 years , with industrialized nations shouldering most of the <WSD>burden</WSD> in the near term .	burden.n.09:01
The U.N.-sponsored climate conference -- characterized so far by unruly posturing and mutual recriminations -- gained renewed focus Friday with the release of a document outlining ambitious greenhouse-gas reductions over the next 40 years , with industrialized nations shouldering most of the burden in the near <WSD>term</WSD> .	term.n.28:00
The <WSD>text</WSD> , which could provide the basis for a final political deal to regulate greenhouse gases , highlighted the remaining obstacles as much as it illuminated a path forward .	text.n.10:00
The text , which could provide the <WSD>basis</WSD> for a final political deal to regulate greenhouse gases , highlighted the remaining obstacles as much as it illuminated a path forward .	basis.n.09:00
The text , which could provide the basis for a final political <WSD>deal</WSD> to regulate greenhouse gases , highlighted the remaining obstacles as much as it illuminated a path forward .	deal.n.10:00
The text , which could provide the basis for a final political deal to regulate <WSD>greenhouse</WSD> gases , highlighted the remaining obstacles as much as it illuminated a path forward .	greenhouse_gas.n.27:00
The text , which could provide the basis for a final political deal to regulate greenhouse gases , highlighted the remaining <WSD>obstacles</WSD> as much as it illuminated a path forward .	obstacle.n.09:00
The text , which could provide the basis for a final political deal to regulate greenhouse gases , highlighted the remaining obstacles as much as it illuminated a <WSD>path</WSD> forward .	path.n.04:00
But it was seen as an important <WSD>advance</WSD> in a negotiation that is running out of time , with more than 100 world leaders arriving in Copenhagen next week .	advance.n.11:01
But it was seen as an important advance in a <WSD>negotiation</WSD> that is running out of time , with more than 100 world leaders arriving in Copenhagen next week .	negotiation.n.10:00
But it was seen as an important advance in a negotiation that is running out of <WSD>time</WSD> , with more than 100 world leaders arriving in Copenhagen next week .	time.n.28:05
But it was seen as an important advance in a negotiation that is running out of time , with more than 100 <WSD>world</WSD> leaders arriving in Copenhagen next week .	world.n.05:00
But it was seen as an important advance in a negotiation that is running out of time , with more than 100 world <WSD>leaders</WSD> arriving in Copenhagen next week .	leader.n.18:00
But it was seen as an important advance in a negotiation that is running out of time , with more than 100 world leaders arriving in <WSD>Copenhagen</WSD> next week .	copenhagen.n.15:00
But it was seen as an important advance in a negotiation that is running out of time , with more than 100 world leaders arriving in Copenhagen next <WSD>week</WSD> .	week.n.28:02
Forged by a U.N. ad-hoc <WSD>working</WSD> group , the text is silent on how much money rich countries would give poor ones to cope with global warming over the short and long term .	working_group.n.14:00
Forged by a U.N. ad-hoc working group , the <WSD>text</WSD> is silent on how much money rich countries would give poor ones to cope with global warming over the short and long term .	text.n.10:00
Forged by a U.N. ad-hoc working group , the text is silent on how much <WSD>money</WSD> rich countries would give poor ones to cope with global warming over the short and long term .	money.n.21:00
Forged by a U.N. ad-hoc working group , the text is silent on how much money rich <WSD>countries</WSD> would give poor ones to cope with global warming over the short and long term .	country.n.14:00
Forged by a U.N. ad-hoc working group , the text is silent on how much money rich countries would give poor <WSD>ones</WSD> to cope with global warming over the short and long term .	one.n.09:00
Forged by a U.N. ad-hoc working group , the text is silent on how much money rich countries would give poor ones to cope with <WSD>global</WSD> warming over the short and long term .	global_warming.n.22:00
Forged by a U.N. ad-hoc working group , the text is silent on how much money rich countries would give poor ones to cope with global warming over the short and long <WSD>term</WSD> .	term.n.28:00
And it provides a <WSD>range</WSD> of options for the key questions , including how developed and major emerging economies would cut their carbon output , and what would be the upper limit of global temperature rise that policymakers would be willing to tolerate .	range.n.07:00
And it provides a range of <WSD>options</WSD> for the key questions , including how developed and major emerging economies would cut their carbon output , and what would be the upper limit of global temperature rise that policymakers would be willing to tolerate .	option.n.09:00
And it provides a range of options for the key <WSD>questions</WSD> , including how developed and major emerging economies would cut their carbon output , and what would be the upper limit of global temperature rise that policymakers would be willing to tolerate .	question.n.10:01
And it provides a range of options for the key questions , including how developed and major emerging economies would cut their carbon output , and what would be the <WSD>upper</WSD> limit of global temperature rise that policymakers would be willing to tolerate .	upper_limit.n.23:00
And it provides a range of options for the key questions , including how developed and major emerging economies would cut their carbon output , and what would be the upper limit of global <WSD>temperature</WSD> rise that policymakers would be willing to tolerate .	temperature.n.07:00
And it provides a range of options for the key questions , including how developed and major emerging economies would cut their carbon output , and what would be the upper limit of global temperature <WSD>rise</WSD> that policymakers would be willing to tolerate .	rise.n.11:00
It gives a <WSD>lot</WSD> of flexibility to the process , said John Coequyt , senior Washington representative for the Sierra Club .	lot.n.23:00
It gives a lot of <WSD>flexibility</WSD> to the process , said John Coequyt , senior Washington representative for the Sierra Club .	flexibility.n.07:01
It gives a lot of flexibility to the <WSD>process</WSD> , said John Coequyt , senior Washington representative for the Sierra Club .	process.n.04:00
It gives a lot of flexibility to the process , said John Coequyt , senior <WSD>Washington</WSD> representative for the Sierra Club .	washington.n.14:00
It gives a lot of flexibility to the process , said John Coequyt , senior Washington <WSD>representative</WSD> for the Sierra Club .	representative.n.18:02
Michael Zammit Cutajar , who drafted the six-page <WSD>document</WSD> , boiled down a 180-page negotiation text to focus on what the U.N. 's top climate official , Yvo de Boer , described as `` the big picture . ''	document.n.10:00
Michael Zammit Cutajar , who drafted the six-page document , boiled down a 180-page <WSD>negotiation</WSD> text to focus on what the U.N. 's top climate official , Yvo de Boer , described as `` the big picture . ''	negotiation.n.10:00
Michael Zammit Cutajar , who drafted the six-page document , boiled down a 180-page negotiation <WSD>text</WSD> to focus on what the U.N. 's top climate official , Yvo de Boer , described as `` the big picture . ''	text.n.10:00
Michael Zammit Cutajar , who drafted the six-page document , boiled down a 180-page negotiation text to focus on what the U.N. 's top <WSD>climate</WSD> official , Yvo de Boer , described as `` the big picture . ''	climate.n.26:00
Michael Zammit Cutajar , who drafted the six-page document , boiled down a 180-page negotiation text to focus on what the U.N. 's top climate <WSD>official</WSD> , Yvo de Boer , described as `` the big picture . ''	official.n.18:01
Michael Zammit Cutajar , who drafted the six-page document , boiled down a 180-page negotiation text to focus on what the U.N. 's top climate official , Yvo de Boer , described as `` the big <WSD>picture</WSD> . ''	picture.n.26:00
It shows the <WSD>outlines</WSD> for a possible deal , in which industrial nations would collectively cut their emissions by 2020 by 25 to 45 percent compared with 1990 levels , while major developing countries would reduce theirs during the same period by 15 to 30 percent .	outline.n.09:00
It shows the outlines for a possible <WSD>deal</WSD> , in which industrial nations would collectively cut their emissions by 2020 by 25 to 45 percent compared with 1990 levels , while major developing countries would reduce theirs during the same period by 15 to 30 percent .	deal.n.10:00
It shows the outlines for a possible deal , in which industrial nations would collectively cut their <WSD>emissions</WSD> by 2020 by 25 to 45 percent compared with 1990 levels , while major developing countries would reduce theirs during the same period by 15 to 30 percent .	emission.n.27:00
It shows the outlines for a possible deal , in which industrial nations would collectively cut their emissions by 2020 by 25 to 45 <WSD>percent</WSD> compared with 1990 levels , while major developing countries would reduce theirs during the same period by 15 to 30 percent .	percent.n.24:00
It shows the outlines for a possible deal , in which industrial nations would collectively cut their emissions by 2020 by 25 to 45 percent compared with 1990 <WSD>levels</WSD> , while major developing countries would reduce theirs during the same period by 15 to 30 percent .	level.n.26:00
It shows the outlines for a possible deal , in which industrial nations would collectively cut their emissions by 2020 by 25 to 45 percent compared with 1990 levels , while major <WSD>developing</WSD> countries would reduce theirs during the same period by 15 to 30 percent .	developing_country.n.14:00
It shows the outlines for a possible deal , in which industrial nations would collectively cut their emissions by 2020 by 25 to 45 percent compared with 1990 levels , while major developing countries would reduce theirs during the same <WSD>period</WSD> by 15 to 30 percent .	period.n.28:00
It shows the outlines for a possible deal , in which industrial nations would collectively cut their emissions by 2020 by 25 to 45 percent compared with 1990 levels , while major developing countries would reduce theirs during the same period by 15 to 30 <WSD>percent</WSD> .	percent.n.24:00
Together , the <WSD>countries</WSD> would cut emissions between 50 and 95 percent by 2050 .	country.n.14:00
Together , the countries would cut <WSD>emissions</WSD> between 50 and 95 percent by 2050 .	emission.n.27:00
Together , the countries would cut emissions between 50 and 95 <WSD>percent</WSD> by 2050 .	percent.n.24:00
The <WSD>European</WSD> Union gave the talks a boost as well on Friday by pledging to provide $ 3.6 billion a year over the next three years to help poorer countries adapt to the impact of climate change -- from coping with flood and drought to avoiding deforestation .	european_union.n.14:00
The European Union gave the <WSD>talks</WSD> a boost as well on Friday by pledging to provide $ 3.6 billion a year over the next three years to help poorer countries adapt to the impact of climate change -- from coping with flood and drought to avoiding deforestation .	talk.n.10:00
The European Union gave the talks a <WSD>boost</WSD> as well on Friday by pledging to provide $ 3.6 billion a year over the next three years to help poorer countries adapt to the impact of climate change -- from coping with flood and drought to avoiding deforestation .	boost.n.04:01
The European Union gave the talks a boost as well on <WSD>Friday</WSD> by pledging to provide $ 3.6 billion a year over the next three years to help poorer countries adapt to the impact of climate change -- from coping with flood and drought to avoiding deforestation .	friday.n.28:00
The European Union gave the talks a boost as well on Friday by pledging to provide $ 3.6 billion a <WSD>year</WSD> over the next three years to help poorer countries adapt to the impact of climate change -- from coping with flood and drought to avoiding deforestation .	year.n.28:01
The European Union gave the talks a boost as well on Friday by pledging to provide $ 3.6 billion a year over the next three <WSD>years</WSD> to help poorer countries adapt to the impact of climate change -- from coping with flood and drought to avoiding deforestation .	year.n.28:01
The European Union gave the talks a boost as well on Friday by pledging to provide $ 3.6 billion a year over the next three years to help poorer <WSD>countries</WSD> adapt to the impact of climate change -- from coping with flood and drought to avoiding deforestation .	country.n.14:00
The European Union gave the talks a boost as well on Friday by pledging to provide $ 3.6 billion a year over the next three years to help poorer countries adapt to the <WSD>impact</WSD> of climate change -- from coping with flood and drought to avoiding deforestation .	impact.n.19:00
The European Union gave the talks a boost as well on Friday by pledging to provide $ 3.6 billion a year over the next three years to help poorer countries adapt to the impact of <WSD>climate</WSD> change -- from coping with flood and drought to avoiding deforestation .	climate_change.n.22:00
The European Union gave the talks a boost as well on Friday by pledging to provide $ 3.6 billion a year over the next three years to help poorer countries adapt to the impact of climate change -- from coping with <WSD>flood</WSD> and drought to avoiding deforestation .	flood.n.19:00
The European Union gave the talks a boost as well on Friday by pledging to provide $ 3.6 billion a year over the next three years to help poorer countries adapt to the impact of climate change -- from coping with flood and <WSD>drought</WSD> to avoiding deforestation .	drought.n.26:00
The European Union gave the talks a boost as well on Friday by pledging to provide $ 3.6 billion a year over the next three years to help poorer countries adapt to the impact of climate change -- from coping with flood and drought to avoiding <WSD>deforestation</WSD> .	deforestation.n.04:00
Still , <WSD>Friday</WSD> featured the same sort of verbal fireworks that have dominated the talks for the past week .	friday.n.28:00
Still , Friday featured the same <WSD>sort</WSD> of verbal fireworks that have dominated the talks for the past week .	sort.n.09:00
Still , Friday featured the same sort of verbal fireworks that have dominated the <WSD>talks</WSD> for the past week .	talk.n.10:00
Still , Friday featured the same sort of verbal fireworks that have dominated the talks for the past <WSD>week</WSD> .	week.n.28:02
<WSD>U.S.</WSD> special climate envoy Todd Stern rejected language requiring binding cuts of greenhouse-gas emissions for industrialized countries compared with voluntary ones by major emerging economies if they were not funded by the developed world .	u.s..n.14:00
U.S. special <WSD>climate</WSD> envoy Todd Stern rejected language requiring binding cuts of greenhouse-gas emissions for industrialized countries compared with voluntary ones by major emerging economies if they were not funded by the developed world .	climate.n.26:00
U.S. special climate <WSD>envoy</WSD> Todd Stern rejected language requiring binding cuts of greenhouse-gas emissions for industrialized countries compared with voluntary ones by major emerging economies if they were not funded by the developed world .	envoy.n.18:00
U.S. special climate envoy Todd Stern rejected <WSD>language</WSD> requiring binding cuts of greenhouse-gas emissions for industrialized countries compared with voluntary ones by major emerging economies if they were not funded by the developed world .	language.n.10:03
U.S. special climate envoy Todd Stern rejected language requiring binding <WSD>cuts</WSD> of greenhouse-gas emissions for industrialized countries compared with voluntary ones by major emerging economies if they were not funded by the developed world .	cut.n.04:05
U.S. special climate envoy Todd Stern rejected language requiring binding cuts of greenhouse-gas <WSD>emissions</WSD> for industrialized countries compared with voluntary ones by major emerging economies if they were not funded by the developed world .	emission.n.27:00
U.S. special climate envoy Todd Stern rejected language requiring binding cuts of greenhouse-gas emissions for industrialized countries compared with voluntary <WSD>ones</WSD> by major emerging economies if they were not funded by the developed world .	one.n.09:00
The <WSD>move</WSD> signaled that the Obama administration is taking a harder line with China than Bush administration officials did just two years ago .	move.n.04:03
The move signaled that the Obama administration is taking a <WSD>harder</WSD> line with China than Bush administration officials did just two years ago .	hard_line.n.09:00
The move signaled that the Obama administration is taking a harder line with <WSD>China</WSD> than Bush administration officials did just two years ago .	china.n.15:00
The move signaled that the Obama administration is taking a harder line with China than <WSD>Bush</WSD> administration officials did just two years ago .	bush_administration.n.14:01
The move signaled that the Obama administration is taking a harder line with China than Bush administration <WSD>officials</WSD> did just two years ago .	official.n.18:01
The move signaled that the Obama administration is taking a harder line with China than Bush administration officials did just two <WSD>years</WSD> ago .	year.n.28:01
The <WSD>United</WSD> States is not going to do a deal without the major developing countries stepping up and taking action , said Stern , who also complained that the text did not do enough to make sure the cuts could be verified by outside observers .	united_states.n.14:00
The United States is not going to do a <WSD>deal</WSD> without the major developing countries stepping up and taking action , said Stern , who also complained that the text did not do enough to make sure the cuts could be verified by outside observers .	deal.n.10:00
The United States is not going to do a deal without the major <WSD>developing</WSD> countries stepping up and taking action , said Stern , who also complained that the text did not do enough to make sure the cuts could be verified by outside observers .	developing_country.n.14:00
The United States is not going to do a deal without the major developing countries stepping up and taking <WSD>action</WSD> , said Stern , who also complained that the text did not do enough to make sure the cuts could be verified by outside observers .	action.n.04:04
The United States is not going to do a deal without the major developing countries stepping up and taking action , said Stern , who also complained that the <WSD>text</WSD> did not do enough to make sure the cuts could be verified by outside observers .	text.n.10:00
The United States is not going to do a deal without the major developing countries stepping up and taking action , said Stern , who also complained that the text did not do enough to make sure the <WSD>cuts</WSD> could be verified by outside observers .	cut.n.04:05
The United States is not going to do a deal without the major developing countries stepping up and taking action , said Stern , who also complained that the text did not do enough to make sure the cuts could be verified by outside <WSD>observers</WSD> .	observer.n.18:01
Stern made his <WSD>comments</WSD> an hour after Chinese vice foreign minister He Yafei said America 's top climate negotiator was either lacking `` common sense '' or being `` extremely irresponsible '' for saying earlier in the week that the United States would not help China financially to cope with global warming .	comment.n.10:00
Stern made his comments an <WSD>hour</WSD> after Chinese vice foreign minister He Yafei said America 's top climate negotiator was either lacking `` common sense '' or being `` extremely irresponsible '' for saying earlier in the week that the United States would not help China financially to cope with global warming .	hour.n.28:01
Stern made his comments an hour after Chinese vice <WSD>foreign</WSD> minister He Yafei said America 's top climate negotiator was either lacking `` common sense '' or being `` extremely irresponsible '' for saying earlier in the week that the United States would not help China financially to cope with global warming .	foreign_minister.n.18:00
Stern made his comments an hour after Chinese vice foreign minister He Yafei said <WSD>America</WSD> 's top climate negotiator was either lacking `` common sense '' or being `` extremely irresponsible '' for saying earlier in the week that the United States would not help China financially to cope with global warming .	america.n.15:00
Stern made his comments an hour after Chinese vice foreign minister He Yafei said America 's top <WSD>climate</WSD> negotiator was either lacking `` common sense '' or being `` extremely irresponsible '' for saying earlier in the week that the United States would not help China financially to cope with global warming .	climate.n.26:00
Stern made his comments an hour after Chinese vice foreign minister He Yafei said America 's top climate <WSD>negotiator</WSD> was either lacking `` common sense '' or being `` extremely irresponsible '' for saying earlier in the week that the United States would not help China financially to cope with global warming .	negotiator.n.18:00
Stern made his comments an hour after Chinese vice foreign minister He Yafei said America 's top climate negotiator was either lacking `` <WSD>common</WSD> sense '' or being `` extremely irresponsible '' for saying earlier in the week that the United States would not help China financially to cope with global warming .	common_sense.n.09:00
Stern made his comments an hour after Chinese vice foreign minister He Yafei said America 's top climate negotiator was either lacking `` common sense '' or being `` extremely irresponsible '' for saying earlier in the <WSD>week</WSD> that the United States would not help China financially to cope with global warming .	week.n.28:02
Stern made his comments an hour after Chinese vice foreign minister He Yafei said America 's top climate negotiator was either lacking `` common sense '' or being `` extremely irresponsible '' for saying earlier in the week that the <WSD>United</WSD> States would not help China financially to cope with global warming .	united_states.n.14:00
Stern made his comments an hour after Chinese vice foreign minister He Yafei said America 's top climate negotiator was either lacking `` common sense '' or being `` extremely irresponsible '' for saying earlier in the week that the United States would not help <WSD>China</WSD> financially to cope with global warming .	china.n.15:00
Stern made his comments an hour after Chinese vice foreign minister He Yafei said America 's top climate negotiator was either lacking `` common sense '' or being `` extremely irresponsible '' for saying earlier in the week that the United States would not help China financially to cope with <WSD>global</WSD> warming .	global_warming.n.22:00
With the future economic <WSD>trajectory</WSD> of the world 's major powers at stake , fault lines have erupted both within the developing world and between the industrial world and emerging economies .	trajectory.n.19:00
With the future economic trajectory of the <WSD>world</WSD> 's major powers at stake , fault lines have erupted both within the developing world and between the industrial world and emerging economies .	world.n.17:00
With the future economic trajectory of the world 's <WSD>major</WSD> powers at stake , fault lines have erupted both within the developing world and between the industrial world and emerging economies .	major_power.n.14:00
With the future economic trajectory of the world 's major powers at stake , <WSD>fault</WSD> lines have erupted both within the developing world and between the industrial world and emerging economies .	fault_line.n.15:00
The current <WSD>battle</WSD> is as much about saving individual economies as saving the planet , with China and United States feuding over their respective obligations while poorer nations insist that the world 's two dozen most influential countries are ignoring the scientific imperative to take bolder action .	battle.n.04:02
The current battle is as much about saving individual <WSD>economies</WSD> as saving the planet , with China and United States feuding over their respective obligations while poorer nations insist that the world 's two dozen most influential countries are ignoring the scientific imperative to take bolder action .	economy.n.14:00
The current battle is as much about saving individual economies as saving the <WSD>planet</WSD> , with China and United States feuding over their respective obligations while poorer nations insist that the world 's two dozen most influential countries are ignoring the scientific imperative to take bolder action .	planet.n.17:00
The current battle is as much about saving individual economies as saving the planet , with <WSD>China</WSD> and United States feuding over their respective obligations while poorer nations insist that the world 's two dozen most influential countries are ignoring the scientific imperative to take bolder action .	china.n.15:00
The current battle is as much about saving individual economies as saving the planet , with China and <WSD>United</WSD> States feuding over their respective obligations while poorer nations insist that the world 's two dozen most influential countries are ignoring the scientific imperative to take bolder action .	united_states.n.14:00
The current battle is as much about saving individual economies as saving the planet , with China and United States feuding over their respective <WSD>obligations</WSD> while poorer nations insist that the world 's two dozen most influential countries are ignoring the scientific imperative to take bolder action .	obligation.n.04:00
The current battle is as much about saving individual economies as saving the planet , with China and United States feuding over their respective obligations while poorer <WSD>nations</WSD> insist that the world 's two dozen most influential countries are ignoring the scientific imperative to take bolder action .	nation.n.14:00
The current battle is as much about saving individual economies as saving the planet , with China and United States feuding over their respective obligations while poorer nations insist that the <WSD>world</WSD> 's two dozen most influential countries are ignoring the scientific imperative to take bolder action .	world.n.17:00
The current battle is as much about saving individual economies as saving the planet , with China and United States feuding over their respective obligations while poorer nations insist that the world 's <WSD>two</WSD> dozen most influential countries are ignoring the scientific imperative to take bolder action .	two_dozen.n.23:00
The current battle is as much about saving individual economies as saving the planet , with China and United States feuding over their respective obligations while poorer nations insist that the world 's two dozen most influential <WSD>countries</WSD> are ignoring the scientific imperative to take bolder action .	country.n.14:00
The current battle is as much about saving individual economies as saving the planet , with China and United States feuding over their respective obligations while poorer nations insist that the world 's two dozen most influential countries are ignoring the scientific <WSD>imperative</WSD> to take bolder action .	imperative.n.04:00
The current battle is as much about saving individual economies as saving the planet , with China and United States feuding over their respective obligations while poorer nations insist that the world 's two dozen most influential countries are ignoring the scientific imperative to take bolder <WSD>action</WSD> .	action.n.04:04
Ricardo Ulate , a Costa Rican <WSD>delegate</WSD> , said it 's not surprising that the major powers are fighting over who should bear the costs for curbing greenhouse gases , even as vulnerable countries have become more aggressive in seeking to hold the big emitters accountable for their actions .	delegate.n.18:00
Ricardo Ulate , a Costa Rican delegate , said it 's not surprising that the <WSD>major</WSD> powers are fighting over who should bear the costs for curbing greenhouse gases , even as vulnerable countries have become more aggressive in seeking to hold the big emitters accountable for their actions .	major_power.n.14:00
Ricardo Ulate , a Costa Rican delegate , said it 's not surprising that the major powers are fighting over who should bear the <WSD>costs</WSD> for curbing greenhouse gases , even as vulnerable countries have become more aggressive in seeking to hold the big emitters accountable for their actions .	cost.n.21:00
Ricardo Ulate , a Costa Rican delegate , said it 's not surprising that the major powers are fighting over who should bear the costs for curbing <WSD>greenhouse</WSD> gases , even as vulnerable countries have become more aggressive in seeking to hold the big emitters accountable for their actions .	greenhouse_gas.n.27:00
Ricardo Ulate , a Costa Rican delegate , said it 's not surprising that the major powers are fighting over who should bear the costs for curbing greenhouse gases , even as vulnerable <WSD>countries</WSD> have become more aggressive in seeking to hold the big emitters accountable for their actions .	country.n.14:00
Ricardo Ulate , a Costa Rican delegate , said it 's not surprising that the major powers are fighting over who should bear the costs for curbing greenhouse gases , even as vulnerable countries have become more aggressive in seeking to hold the big emitters accountable for their <WSD>actions</WSD> .	action.n.04:02
This is clearly a <WSD>game</WSD> where a new economic hegemony is being developed , said Ulate , who also serves as the regional Mexico and Central America climate change adviser for Conservation International .	game.n.09:00
This is clearly a game where a new economic <WSD>hegemony</WSD> is being developed , said Ulate , who also serves as the regional Mexico and Central America climate change adviser for Conservation International .	hegemony.n.14:00
This is clearly a game where a new economic hegemony is being developed , said Ulate , who also serves as the regional <WSD>Mexico</WSD> and Central America climate change adviser for Conservation International .	mexico.n.15:00
This is clearly a game where a new economic hegemony is being developed , said Ulate , who also serves as the regional Mexico and <WSD>Central</WSD> America climate change adviser for Conservation International .	central_america.n.14:00
This is clearly a game where a new economic hegemony is being developed , said Ulate , who also serves as the regional Mexico and Central America <WSD>climate</WSD> change adviser for Conservation International .	climate_change.n.22:00
This is clearly a game where a new economic hegemony is being developed , said Ulate , who also serves as the regional Mexico and Central America climate change <WSD>adviser</WSD> for Conservation International .	adviser.n.18:00
Some of the <WSD>countries</WSD> most vulnerable to the impact of climate change indicated they would continue to push for a legally binding treaty in Copenhagen , although most of the major participants say the talks will produce a political deal at best .	country.n.14:00
Some of the countries most vulnerable to the <WSD>impact</WSD> of climate change indicated they would continue to push for a legally binding treaty in Copenhagen , although most of the major participants say the talks will produce a political deal at best .	impact.n.19:00
Some of the countries most vulnerable to the impact of <WSD>climate</WSD> change indicated they would continue to push for a legally binding treaty in Copenhagen , although most of the major participants say the talks will produce a political deal at best .	climate_change.n.22:00
Some of the countries most vulnerable to the impact of climate change indicated they would continue to push for a legally binding <WSD>treaty</WSD> in Copenhagen , although most of the major participants say the talks will produce a political deal at best .	treaty.n.10:00
Some of the countries most vulnerable to the impact of climate change indicated they would continue to push for a legally binding treaty in <WSD>Copenhagen</WSD> , although most of the major participants say the talks will produce a political deal at best .	copenhagen.n.15:00
Some of the countries most vulnerable to the impact of climate change indicated they would continue to push for a legally binding treaty in Copenhagen , although most of the major <WSD>participants</WSD> say the talks will produce a political deal at best .	participant.n.18:00
Some of the countries most vulnerable to the impact of climate change indicated they would continue to push for a legally binding treaty in Copenhagen , although most of the major participants say the <WSD>talks</WSD> will produce a political deal at best .	talk.n.10:00
Some of the countries most vulnerable to the impact of climate change indicated they would continue to push for a legally binding treaty in Copenhagen , although most of the major participants say the talks will produce a political <WSD>deal</WSD> at best .	deal.n.10:00
The Alliance of Small Island States , which has 43 <WSD>members</WSD> , produced a 24-page draft treaty proposal early Friday morning .	member.n.14:00
The Alliance of Small Island States , which has 43 members , produced a 24-page <WSD>draft</WSD> treaty proposal early Friday morning .	draft.n.10:00
The Alliance of Small Island States , which has 43 members , produced a 24-page draft <WSD>treaty</WSD> proposal early Friday morning .	treaty.n.10:00
The Alliance of Small Island States , which has 43 members , produced a 24-page draft treaty <WSD>proposal</WSD> early Friday morning .	proposal.n.10:00
The Alliance of Small Island States , which has 43 members , produced a 24-page draft treaty proposal early <WSD>Friday</WSD> morning .	friday.n.28:00
The Alliance of Small Island States , which has 43 members , produced a 24-page draft treaty proposal early Friday <WSD>morning</WSD> .	morning.n.28:00
Artur Runge-Metzger , who heads international <WSD>climate</WSD> negotiations on behalf of the European Commission , said the push by small island nations has `` put political pressure on the entire political process , '' in part because they are now unified and demanding action from emerging economies such as China and India .	climate.n.26:00
Artur Runge-Metzger , who heads international climate <WSD>negotiations</WSD> on behalf of the European Commission , said the push by small island nations has `` put political pressure on the entire political process , '' in part because they are now unified and demanding action from emerging economies such as China and India .	negotiation.n.10:00
Artur Runge-Metzger , who heads international climate negotiations on <WSD>behalf</WSD> of the European Commission , said the push by small island nations has `` put political pressure on the entire political process , '' in part because they are now unified and demanding action from emerging economies such as China and India .	behalf.n.04:00
Artur Runge-Metzger , who heads international climate negotiations on behalf of the European Commission , said the <WSD>push</WSD> by small island nations has `` put political pressure on the entire political process , '' in part because they are now unified and demanding action from emerging economies such as China and India .	push.n.04:01
Artur Runge-Metzger , who heads international climate negotiations on behalf of the European Commission , said the push by small island nations has `` put political <WSD>pressure</WSD> on the entire political process , '' in part because they are now unified and demanding action from emerging economies such as China and India .	pressure.n.07:00
Artur Runge-Metzger , who heads international climate negotiations on behalf of the European Commission , said the push by small island nations has `` put political pressure on the entire political <WSD>process</WSD> , '' in part because they are now unified and demanding action from emerging economies such as China and India .	process.n.04:00
Artur Runge-Metzger , who heads international climate negotiations on behalf of the European Commission , said the push by small island nations has `` put political pressure on the entire political process , '' in part because they are now unified and demanding <WSD>action</WSD> from emerging economies such as China and India .	action.n.04:04
Artur Runge-Metzger , who heads international climate negotiations on behalf of the European Commission , said the push by small island nations has `` put political pressure on the entire political process , '' in part because they are now unified and demanding action from emerging economies such as <WSD>China</WSD> and India .	china.n.15:00
Artur Runge-Metzger , who heads international climate negotiations on behalf of the European Commission , said the push by small island nations has `` put political pressure on the entire political process , '' in part because they are now unified and demanding action from emerging economies such as China and <WSD>India</WSD> .	india.n.15:00
The <WSD>talks</WSD> took on new urgency as delegates focused on the fact that they must resolve most of the outstanding issues before the heads of government arrive to strike a deal .	talk.n.10:00
The talks took on new <WSD>urgency</WSD> as delegates focused on the fact that they must resolve most of the outstanding issues before the heads of government arrive to strike a deal .	urgency.n.26:00
The talks took on new urgency as <WSD>delegates</WSD> focused on the fact that they must resolve most of the outstanding issues before the heads of government arrive to strike a deal .	delegate.n.18:00
The talks took on new urgency as delegates focused on the <WSD>fact</WSD> that they must resolve most of the outstanding issues before the heads of government arrive to strike a deal .	fact.n.09:01
The talks took on new urgency as delegates focused on the fact that they must resolve most of the outstanding <WSD>issues</WSD> before the heads of government arrive to strike a deal .	issue.n.09:01
The talks took on new urgency as delegates focused on the fact that they must resolve most of the outstanding issues before the heads of government arrive to strike a <WSD>deal</WSD> .	deal.n.10:00
High-level <WSD>officials</WSD> such as Indian environment minister Jairam Ramesh and the Chinese vice minister stepped off planes and raced through the Bella Center 's halls to closed-door meetings and news conferences so they could stake out claims that will be arbitrated over the next week .	official.n.18:01
High-level officials such as Indian environment minister Jairam Ramesh and the Chinese vice <WSD>minister</WSD> stepped off planes and raced through the Bella Center 's halls to closed-door meetings and news conferences so they could stake out claims that will be arbitrated over the next week .	minister.n.18:02
High-level officials such as Indian environment minister Jairam Ramesh and the Chinese vice minister stepped off <WSD>planes</WSD> and raced through the Bella Center 's halls to closed-door meetings and news conferences so they could stake out claims that will be arbitrated over the next week .	plane.n.06:01
High-level officials such as Indian environment minister Jairam Ramesh and the Chinese vice minister stepped off planes and raced through the Bella Center 's <WSD>halls</WSD> to closed-door meetings and news conferences so they could stake out claims that will be arbitrated over the next week .	hall.n.06:03
High-level officials such as Indian environment minister Jairam Ramesh and the Chinese vice minister stepped off planes and raced through the Bella Center 's halls to closed-door <WSD>meetings</WSD> and news conferences so they could stake out claims that will be arbitrated over the next week .	meeting.n.14:00
High-level officials such as Indian environment minister Jairam Ramesh and the Chinese vice minister stepped off planes and raced through the Bella Center 's halls to closed-door meetings and <WSD>news</WSD> conferences so they could stake out claims that will be arbitrated over the next week .	news_conference.n.10:00
High-level officials such as Indian environment minister Jairam Ramesh and the Chinese vice minister stepped off planes and raced through the Bella Center 's halls to closed-door meetings and news conferences so they could stake out <WSD>claims</WSD> that will be arbitrated over the next week .	claim.n.04:00
High-level officials such as Indian environment minister Jairam Ramesh and the Chinese vice minister stepped off planes and raced through the Bella Center 's halls to closed-door meetings and news conferences so they could stake out claims that will be arbitrated over the next <WSD>week</WSD> .	week.n.28:02
The sheer sprawl of the <WSD>gathering</WSD> -- where 13,000 people move in and out of the convention center each day , guitar-playing activists put on nightly shows mocking the countries they think are selling out , and draft proposals are passed hand-to-hand on paper rather than via e-mail -- poses a challenge .	gathering.n.14:00
The sheer sprawl of the gathering -- where 13,000 <WSD>people</WSD> move in and out of the convention center each day , guitar-playing activists put on nightly shows mocking the countries they think are selling out , and draft proposals are passed hand-to-hand on paper rather than via e-mail -- poses a challenge .	people.n.14:00
The sheer sprawl of the gathering -- where 13,000 people move in and out of the convention center each <WSD>day</WSD> , guitar-playing activists put on nightly shows mocking the countries they think are selling out , and draft proposals are passed hand-to-hand on paper rather than via e-mail -- poses a challenge .	day.n.28:00
The sheer sprawl of the gathering -- where 13,000 people move in and out of the convention center each day , guitar-playing <WSD>activists</WSD> put on nightly shows mocking the countries they think are selling out , and draft proposals are passed hand-to-hand on paper rather than via e-mail -- poses a challenge .	activist.n.18:00
The sheer sprawl of the gathering -- where 13,000 people move in and out of the convention center each day , guitar-playing activists put on nightly <WSD>shows</WSD> mocking the countries they think are selling out , and draft proposals are passed hand-to-hand on paper rather than via e-mail -- poses a challenge .	show.n.04:00
The sheer sprawl of the gathering -- where 13,000 people move in and out of the convention center each day , guitar-playing activists put on nightly shows mocking the <WSD>countries</WSD> they think are selling out , and draft proposals are passed hand-to-hand on paper rather than via e-mail -- poses a challenge .	country.n.14:00
The sheer sprawl of the gathering -- where 13,000 people move in and out of the convention center each day , guitar-playing activists put on nightly shows mocking the countries they think are selling out , and <WSD>draft</WSD> proposals are passed hand-to-hand on paper rather than via e-mail -- poses a challenge .	draft.n.10:00
The sheer sprawl of the gathering -- where 13,000 people move in and out of the convention center each day , guitar-playing activists put on nightly shows mocking the countries they think are selling out , and draft <WSD>proposals</WSD> are passed hand-to-hand on paper rather than via e-mail -- poses a challenge .	proposal.n.10:00
The sheer sprawl of the gathering -- where 13,000 people move in and out of the convention center each day , guitar-playing activists put on nightly shows mocking the countries they think are selling out , and draft proposals are passed hand-to-hand on <WSD>paper</WSD> rather than via e-mail -- poses a challenge .	paper.n.27:00
The sheer sprawl of the gathering -- where 13,000 people move in and out of the convention center each day , guitar-playing activists put on nightly shows mocking the countries they think are selling out , and draft proposals are passed hand-to-hand on paper rather than via <WSD>e-mail</WSD> -- poses a challenge .	e-mail.n.10:00
The sheer sprawl of the gathering -- where 13,000 people move in and out of the convention center each day , guitar-playing activists put on nightly shows mocking the countries they think are selling out , and draft proposals are passed hand-to-hand on paper rather than via e-mail -- poses a <WSD>challenge</WSD> .	challenge.n.26:00
The <WSD>intensity</WSD> is only building : nearly all of the key ministers are now here , and as early as Wednesday 60 heads of government will be in Copenhagen .	intensity.n.07:00
The intensity is only building : nearly all of the key <WSD>ministers</WSD> are now here , and as early as Wednesday 60 heads of government will be in Copenhagen .	minister.n.18:02
The intensity is only building : nearly all of the key ministers are now here , and as early as <WSD>Wednesday</WSD> 60 heads of government will be in Copenhagen .	wednesday.n.28:00
The intensity is only building : nearly all of the key ministers are now here , and as early as Wednesday 60 heads of government will be in <WSD>Copenhagen</WSD> .	copenhagen.n.15:00
We 're getting into the <WSD>big</WSD> leagues , said Carlos Manuel Rodriguez , vice president for global policy at Conservation International .	big_league.n.14:00
We 're getting into the big leagues , said Carlos Manuel Rodriguez , <WSD>vice</WSD> president for global policy at Conservation International .	vice_president.n.18:00
We 're getting into the big leagues , said Carlos Manuel Rodriguez , vice president for global <WSD>policy</WSD> at Conservation International .	policy.n.10:00
The <WSD>heavyweights</WSD> are coming .	heavyweight.n.18:00
Baskonia gives away a <WSD>victory</WSD> in Israel	victory.n.11:00
Baskonia gives away a victory in <WSD>Israel</WSD>	israel.n.15:00
Caja Laboral achieved a stunning 82-91 <WSD>victory</WSD> on their visit to the Maccabee Electra court despite Dusko Ivanovic 's team 's heavy losses , and after the great performance by Mizra Teltovic , who was the best on his team with eight three-pointers scored ( 29 points ) , they now at the top of their group .	victory.n.11:00
Caja Laboral achieved a stunning 82-91 victory on their <WSD>visit</WSD> to the Maccabee Electra court despite Dusko Ivanovic 's team 's heavy losses , and after the great performance by Mizra Teltovic , who was the best on his team with eight three-pointers scored ( 29 points ) , they now at the top of their group .	visit.n.04:02
Caja Laboral achieved a stunning 82-91 victory on their visit to the Maccabee Electra court despite Dusko Ivanovic 's <WSD>team</WSD> 's heavy losses , and after the great performance by Mizra Teltovic , who was the best on his team with eight three-pointers scored ( 29 points ) , they now at the top of their group .	team.n.14:00
Caja Laboral achieved a stunning 82-91 victory on their visit to the Maccabee Electra court despite Dusko Ivanovic 's team 's heavy <WSD>losses</WSD> , and after the great performance by Mizra Teltovic , who was the best on his team with eight three-pointers scored ( 29 points ) , they now at the top of their group .	loss.n.04:00
Caja Laboral achieved a stunning 82-91 victory on their visit to the Maccabee Electra court despite Dusko Ivanovic 's team 's heavy losses , and after the great <WSD>performance</WSD> by Mizra Teltovic , who was the best on his team with eight three-pointers scored ( 29 points ) , they now at the top of their group .	performance.n.04:00
Caja Laboral achieved a stunning 82-91 victory on their visit to the Maccabee Electra court despite Dusko Ivanovic 's team 's heavy losses , and after the great performance by Mizra Teltovic , who was the best on his <WSD>team</WSD> with eight three-pointers scored ( 29 points ) , they now at the top of their group .	team.n.14:00
Caja Laboral achieved a stunning 82-91 victory on their visit to the Maccabee Electra court despite Dusko Ivanovic 's team 's heavy losses , and after the great performance by Mizra Teltovic , who was the best on his team with eight three-pointers scored ( 29 <WSD>points</WSD> ) , they now at the top of their group .	point.n.23:01
Caja Laboral achieved a stunning 82-91 victory on their visit to the Maccabee Electra court despite Dusko Ivanovic 's team 's heavy losses , and after the great performance by Mizra Teltovic , who was the best on his team with eight three-pointers scored ( 29 points ) , they now at the <WSD>top</WSD> of their group .	top.n.26:00
Caja Laboral achieved a stunning 82-91 victory on their visit to the Maccabee Electra court despite Dusko Ivanovic 's team 's heavy losses , and after the great performance by Mizra Teltovic , who was the best on his team with eight three-pointers scored ( 29 points ) , they now at the top of their <WSD>group</WSD> .	group.n.03:00
The Vitorian <WSD>team</WSD> knew to make up for the significant absences of Herrmann , Oleson , Huertas and Micov with a big dose of involvement and teamwork , even though it had to hold out until the end to take the victory .	team.n.14:00
The Vitorian team knew to make up for the significant <WSD>absences</WSD> of Herrmann , Oleson , Huertas and Micov with a big dose of involvement and teamwork , even though it had to hold out until the end to take the victory .	absence.n.26:00
The Vitorian team knew to make up for the significant absences of Herrmann , Oleson , Huertas and Micov with a big dose of <WSD>involvement</WSD> and teamwork , even though it had to hold out until the end to take the victory .	involvement.n.04:00
The Vitorian team knew to make up for the significant absences of Herrmann , Oleson , Huertas and Micov with a big dose of involvement and <WSD>teamwork</WSD> , even though it had to hold out until the end to take the victory .	teamwork.n.04:00
The Vitorian team knew to make up for the significant absences of Herrmann , Oleson , Huertas and Micov with a big dose of involvement and teamwork , even though it had to hold out until the <WSD>end</WSD> to take the victory .	end.n.11:00
The Vitorian team knew to make up for the significant absences of Herrmann , Oleson , Huertas and Micov with a big dose of involvement and teamwork , even though it had to hold out until the end to take the <WSD>victory</WSD> .	victory.n.11:00
Additionally , their huge <WSD>success</WSD> from the sidelines , with 16 three pointers scored , had a lot to do with the final triumph .	success.n.26:00
Additionally , their huge success from the <WSD>sidelines</WSD> , with 16 three pointers scored , had a lot to do with the final triumph .	sideline.n.15:00
Additionally , their huge success from the sidelines , with 16 three pointers scored , had a <WSD>lot</WSD> to do with the final triumph .	lot.n.23:00
Additionally , their huge success from the sidelines , with 16 three pointers scored , had a lot to do with the final <WSD>triumph</WSD> .	triumph.n.11:00
The <WSD>game</WSD> started out in favor of the Azulgranas , who put themselves ahead on the scoreboard from the start .	game.n.04:03
The game started out in <WSD>favor</WSD> of the Azulgranas , who put themselves ahead on the scoreboard from the start .	favor.n.07:00
The game started out in favor of the Azulgranas , who put themselves ahead on the <WSD>scoreboard</WSD> from the start .	scoreboard.n.06:00
The game started out in favor of the Azulgranas , who put themselves ahead on the scoreboard from the <WSD>start</WSD> .	start.n.11:00
As Vitora 's first four <WSD>baskets</WSD> were from the perimeter , the speculation was already that they had jumped into the Israeli net with hot wrists .	basket.n.04:00
As Vitora 's first four baskets were from the <WSD>perimeter</WSD> , the speculation was already that they had jumped into the Israeli net with hot wrists .	perimeter.n.25:00
As Vitora 's first four baskets were from the perimeter , the <WSD>speculation</WSD> was already that they had jumped into the Israeli net with hot wrists .	speculation.n.10:03
As Vitora 's first four baskets were from the perimeter , the speculation was already that they had jumped into the Israeli <WSD>net</WSD> with hot wrists .	net.n.06:04
As Vitora 's first four baskets were from the perimeter , the speculation was already that they had jumped into the Israeli net with hot <WSD>wrists</WSD> .	wrist.n.08:00
English and Teletovic were the main <WSD>scorers</WSD> of the 18-20 at the end of the first period .	scorer.n.18:00
English and Teletovic were the main scorers of the 18-20 at the <WSD>end</WSD> of the first period .	end.n.11:00
English and Teletovic were the main scorers of the 18-20 at the end of the <WSD>first</WSD> period .	first_period.n.28:00
The second <WSD>quarter</WSD> was more of the same , but the Alavan team opted for the inside game of Barac and the work of Eliyahu , who was greeted with whistles and applause at his return home , to continue increasing their lead by half-time ( 34-43 ) .	quarter.n.28:01
The second quarter was more of the same , but the Alavan <WSD>team</WSD> opted for the inside game of Barac and the work of Eliyahu , who was greeted with whistles and applause at his return home , to continue increasing their lead by half-time ( 34-43 ) .	team.n.14:00
The second quarter was more of the same , but the Alavan team opted for the inside <WSD>game</WSD> of Barac and the work of Eliyahu , who was greeted with whistles and applause at his return home , to continue increasing their lead by half-time ( 34-43 ) .	game.n.04:03
The second quarter was more of the same , but the Alavan team opted for the inside game of Barac and the <WSD>work</WSD> of Eliyahu , who was greeted with whistles and applause at his return home , to continue increasing their lead by half-time ( 34-43 ) .	work.n.04:00
The second quarter was more of the same , but the Alavan team opted for the inside game of Barac and the work of Eliyahu , who was greeted with <WSD>whistles</WSD> and applause at his return home , to continue increasing their lead by half-time ( 34-43 ) .	whistle.n.10:00
The second quarter was more of the same , but the Alavan team opted for the inside game of Barac and the work of Eliyahu , who was greeted with whistles and <WSD>applause</WSD> at his return home , to continue increasing their lead by half-time ( 34-43 ) .	applause.n.10:00
The second quarter was more of the same , but the Alavan team opted for the inside game of Barac and the work of Eliyahu , who was greeted with whistles and applause at his <WSD>return</WSD> home , to continue increasing their lead by half-time ( 34-43 ) .	return.n.04:01
The second quarter was more of the same , but the Alavan team opted for the inside game of Barac and the work of Eliyahu , who was greeted with whistles and applause at his return <WSD>home</WSD> , to continue increasing their lead by half-time ( 34-43 ) .	home.n.15:02
The second quarter was more of the same , but the Alavan team opted for the inside game of Barac and the work of Eliyahu , who was greeted with whistles and applause at his return home , to continue increasing their <WSD>lead</WSD> by half-time ( 34-43 ) .	lead.n.07:02
Teletovic had already begun to stand out as the best on his <WSD>team</WSD> with 13 points , even though Splitter 's `` six fewer '' points already signaled that it was n't going to be the best night for the Brazilian .	team.n.14:00
Teletovic had already begun to stand out as the best on his team with 13 <WSD>points</WSD> , even though Splitter 's `` six fewer '' points already signaled that it was n't going to be the best night for the Brazilian .	point.n.23:01
Teletovic had already begun to stand out as the best on his team with 13 points , even though Splitter 's `` six fewer '' <WSD>points</WSD> already signaled that it was n't going to be the best night for the Brazilian .	point.n.23:01
Teletovic had already begun to stand out as the best on his team with 13 points , even though Splitter 's `` six fewer '' points already signaled that it was n't going to be the best <WSD>night</WSD> for the Brazilian .	night.n.28:00
But the <WSD>game</WSD> , despite being headed for halftime , was not more decidedand the Maccabees tried to remind the Vitorians that not just anybody wins on their court , and with the ` hand of Elias ' putting the pressure on , they managed to get involved in the game .	game.n.04:03
But the game , despite being headed for <WSD>halftime</WSD> , was not more decidedand the Maccabees tried to remind the Vitorians that not just anybody wins on their court , and with the ` hand of Elias ' putting the pressure on , they managed to get involved in the game .	halftime.n.28:00
But the game , despite being headed for halftime , was not more decidedand the Maccabees tried to remind the Vitorians that not just anybody wins on their court , and with the ` <WSD>hand</WSD> of Elias ' putting the pressure on , they managed to get involved in the game .	hand.n.08:00
But the game , despite being headed for halftime , was not more decidedand the Maccabees tried to remind the Vitorians that not just anybody wins on their court , and with the ` hand of Elias ' putting the <WSD>pressure</WSD> on , they managed to get involved in the game .	pressure.n.07:00
But the game , despite being headed for halftime , was not more decidedand the Maccabees tried to remind the Vitorians that not just anybody wins on their court , and with the ` hand of Elias ' putting the pressure on , they managed to get involved in the <WSD>game</WSD> .	game.n.04:03
Eidson and Pnini played a decisive <WSD>role</WSD> in the `` yellows ' '' return to the light .	role.n.04:00
Eidson and Pnini played a decisive role in the `` yellows ' '' <WSD>return</WSD> to the light .	return.n.04:02
Eidson and Pnini played a decisive role in the `` yellows ' '' return to the <WSD>light</WSD> .	light.n.09:02
More <WSD>disadvantages</WSD>	disadvantage.n.07:00
Ivanovic 's <WSD>players</WSD> , injured but far from dead , needed to run a couple of plays correctly before they could breathe , and that 's when the machine gun Marza Teletovic arrived , with three almost consecutive three-pointers and the help of English and Ribas , he brought the scoreboard back to a reassuring lead ( 54-67 ) , which the home team managed to narrow down at the end of the third quarter ( 57-67 ) .	player.n.18:01
Ivanovic 's players , injured but far from dead , needed to run a <WSD>couple</WSD> of plays correctly before they could breathe , and that 's when the machine gun Marza Teletovic arrived , with three almost consecutive three-pointers and the help of English and Ribas , he brought the scoreboard back to a reassuring lead ( 54-67 ) , which the home team managed to narrow down at the end of the third quarter ( 57-67 ) .	couple.n.23:01
Ivanovic 's players , injured but far from dead , needed to run a couple of <WSD>plays</WSD> correctly before they could breathe , and that 's when the machine gun Marza Teletovic arrived , with three almost consecutive three-pointers and the help of English and Ribas , he brought the scoreboard back to a reassuring lead ( 54-67 ) , which the home team managed to narrow down at the end of the third quarter ( 57-67 ) .	play.n.04:05
Ivanovic 's players , injured but far from dead , needed to run a couple of plays correctly before they could breathe , and that 's when the machine gun Marza Teletovic arrived , with three almost consecutive three-pointers and the <WSD>help</WSD> of English and Ribas , he brought the scoreboard back to a reassuring lead ( 54-67 ) , which the home team managed to narrow down at the end of the third quarter ( 57-67 ) .	help.n.04:00
Ivanovic 's players , injured but far from dead , needed to run a couple of plays correctly before they could breathe , and that 's when the machine gun Marza Teletovic arrived , with three almost consecutive three-pointers and the help of English and Ribas , he brought the <WSD>scoreboard</WSD> back to a reassuring lead ( 54-67 ) , which the home team managed to narrow down at the end of the third quarter ( 57-67 ) .	scoreboard.n.06:00
Ivanovic 's players , injured but far from dead , needed to run a couple of plays correctly before they could breathe , and that 's when the machine gun Marza Teletovic arrived , with three almost consecutive three-pointers and the help of English and Ribas , he brought the scoreboard back to a reassuring <WSD>lead</WSD> ( 54-67 ) , which the home team managed to narrow down at the end of the third quarter ( 57-67 ) .	lead.n.07:02
Ivanovic 's players , injured but far from dead , needed to run a couple of plays correctly before they could breathe , and that 's when the machine gun Marza Teletovic arrived , with three almost consecutive three-pointers and the help of English and Ribas , he brought the scoreboard back to a reassuring lead ( 54-67 ) , which the home <WSD>team</WSD> managed to narrow down at the end of the third quarter ( 57-67 ) .	team.n.14:00
Ivanovic 's players , injured but far from dead , needed to run a couple of plays correctly before they could breathe , and that 's when the machine gun Marza Teletovic arrived , with three almost consecutive three-pointers and the help of English and Ribas , he brought the scoreboard back to a reassuring lead ( 54-67 ) , which the home team managed to narrow down at the <WSD>end</WSD> of the third quarter ( 57-67 ) .	end.n.28:00
Ivanovic 's players , injured but far from dead , needed to run a couple of plays correctly before they could breathe , and that 's when the machine gun Marza Teletovic arrived , with three almost consecutive three-pointers and the help of English and Ribas , he brought the scoreboard back to a reassuring lead ( 54-67 ) , which the home team managed to narrow down at the end of the third <WSD>quarter</WSD> ( 57-67 ) .	quarter.n.28:01
The Alavas worked themselves to the bone in the last <WSD>period</WSD> , and English and San Emeterio ( 65-75 ) had already made it clear that they were not going to let anyone take away what they had earned during the first thirty minutes .	period.n.28:02
The Alavas worked themselves to the bone in the last period , and English and San Emeterio ( 65-75 ) had already made it clear that they were not going to let anyone take away what they had earned during the first thirty <WSD>minutes</WSD> .	minute.n.28:00
However , Pnini and Eidson , the best on their <WSD>team</WSD> , did not give up and tried to keep their team alive from the three-point line ( 70-77 ) .	team.n.14:00
However , Pnini and Eidson , the best on their team , did not give up and tried to keep their <WSD>team</WSD> alive from the three-point line ( 70-77 ) .	team.n.14:00
However , Pnini and Eidson , the best on their team , did not give up and tried to keep their team alive from the three-point <WSD>line</WSD> ( 70-77 ) .	line.n.15:01
In <WSD>spite</WSD> of this , and with Splitter fouling out , Ivonic 's team did n't rush , defended well , and , even though the Israelis came close at the last minute , the game was already won and victory escaped Tel Aviv for the first time in the season .	spite.n.12:00
In spite of this , and with Splitter fouling out , Ivonic 's <WSD>team</WSD> did n't rush , defended well , and , even though the Israelis came close at the last minute , the game was already won and victory escaped Tel Aviv for the first time in the season .	team.n.14:00
In spite of this , and with Splitter fouling out , Ivonic 's team did n't rush , defended well , and , even though the Israelis came close at the <WSD>last</WSD> minute , the game was already won and victory escaped Tel Aviv for the first time in the season .	last_minute.n.28:00
In spite of this , and with Splitter fouling out , Ivonic 's team did n't rush , defended well , and , even though the Israelis came close at the last minute , the <WSD>game</WSD> was already won and victory escaped Tel Aviv for the first time in the season .	game.n.04:03
In spite of this , and with Splitter fouling out , Ivonic 's team did n't rush , defended well , and , even though the Israelis came close at the last minute , the game was already won and <WSD>victory</WSD> escaped Tel Aviv for the first time in the season .	victory.n.11:00
In spite of this , and with Splitter fouling out , Ivonic 's team did n't rush , defended well , and , even though the Israelis came close at the last minute , the game was already won and victory escaped Tel Aviv for the first <WSD>time</WSD> in the season .	time.n.11:00
In spite of this , and with Splitter fouling out , Ivonic 's team did n't rush , defended well , and , even though the Israelis came close at the last minute , the game was already won and victory escaped Tel Aviv for the first time in the <WSD>season</WSD> .	season.n.28:02
<WSD>Wall</WSD> Street closes without momentum , slowed by a strengthening dollar	wall_street.n.14:00
Wall Street closes without <WSD>momentum</WSD> , slowed by a strengthening dollar	momentum.n.07:00
Wall Street closes without momentum , slowed by a strengthening <WSD>dollar</WSD>	dollar.n.23:00
The <WSD>New</WSD> York Stock Exchange closed with no particular heading on Friday , in a market torn between better than expected indicators in the United States and a strengthening dollar : the Dow Jones gained 0.63 % but the NASDAQ dropped 0.03 % .	new_york_stock_exchange.n.06:00
The New York Stock Exchange closed with no particular <WSD>heading</WSD> on Friday , in a market torn between better than expected indicators in the United States and a strengthening dollar : the Dow Jones gained 0.63 % but the NASDAQ dropped 0.03 % .	heading.n.15:00
The New York Stock Exchange closed with no particular heading on <WSD>Friday</WSD> , in a market torn between better than expected indicators in the United States and a strengthening dollar : the Dow Jones gained 0.63 % but the NASDAQ dropped 0.03 % .	friday.n.28:00
The New York Stock Exchange closed with no particular heading on Friday , in a <WSD>market</WSD> torn between better than expected indicators in the United States and a strengthening dollar : the Dow Jones gained 0.63 % but the NASDAQ dropped 0.03 % .	market.n.14:01
The New York Stock Exchange closed with no particular heading on Friday , in a market torn between better than expected <WSD>indicators</WSD> in the United States and a strengthening dollar : the Dow Jones gained 0.63 % but the NASDAQ dropped 0.03 % .	indicator.n.10:00
The New York Stock Exchange closed with no particular heading on Friday , in a market torn between better than expected indicators in the <WSD>United</WSD> States and a strengthening dollar : the Dow Jones gained 0.63 % but the NASDAQ dropped 0.03 % .	united_states.n.15:00
The New York Stock Exchange closed with no particular heading on Friday , in a market torn between better than expected indicators in the United States and a strengthening <WSD>dollar</WSD> : the Dow Jones gained 0.63 % but the NASDAQ dropped 0.03 % .	dollar.n.23:00
The New York Stock Exchange closed with no particular heading on Friday , in a market torn between better than expected indicators in the United States and a strengthening dollar : the <WSD>Dow</WSD> Jones gained 0.63 % but the NASDAQ dropped 0.03 % .	dow_jones.n.10:00
The New York Stock Exchange closed with no particular heading on Friday , in a market torn between better than expected indicators in the United States and a strengthening dollar : the Dow Jones gained 0.63 % but the <WSD>NASDAQ</WSD> dropped 0.03 % .	nasdaq.n.06:00
According to final <WSD>closing</WSD> figures , the Dow Jones Industrial Average has risen by 65.67 points to 10 471.50 points , whereas the NASDAQ , with a technology predominance , fell by 0.55 point to 2 190.31 points .	closing.n.04:02
According to final closing <WSD>figures</WSD> , the Dow Jones Industrial Average has risen by 65.67 points to 10 471.50 points , whereas the NASDAQ , with a technology predominance , fell by 0.55 point to 2 190.31 points .	figure.n.07:01
According to final closing figures , the Dow Jones Industrial Average has risen by 65.67 <WSD>points</WSD> to 10 471.50 points , whereas the NASDAQ , with a technology predominance , fell by 0.55 point to 2 190.31 points .	point.n.26:00
According to final closing figures , the Dow Jones Industrial Average has risen by 65.67 points to 10 471.50 <WSD>points</WSD> , whereas the NASDAQ , with a technology predominance , fell by 0.55 point to 2 190.31 points .	point.n.26:00
According to final closing figures , the Dow Jones Industrial Average has risen by 65.67 points to 10 471.50 points , whereas the <WSD>NASDAQ</WSD> , with a technology predominance , fell by 0.55 point to 2 190.31 points .	nasdaq.n.06:00
According to final closing figures , the Dow Jones Industrial Average has risen by 65.67 points to 10 471.50 points , whereas the NASDAQ , with a <WSD>technology</WSD> predominance , fell by 0.55 point to 2 190.31 points .	technology.n.09:00
According to final closing figures , the Dow Jones Industrial Average has risen by 65.67 points to 10 471.50 points , whereas the NASDAQ , with a technology <WSD>predominance</WSD> , fell by 0.55 point to 2 190.31 points .	predominance.n.26:00
According to final closing figures , the Dow Jones Industrial Average has risen by 65.67 points to 10 471.50 points , whereas the NASDAQ , with a technology predominance , fell by 0.55 <WSD>point</WSD> to 2 190.31 points .	point.n.26:00
According to final closing figures , the Dow Jones Industrial Average has risen by 65.67 points to 10 471.50 points , whereas the NASDAQ , with a technology predominance , fell by 0.55 point to 2 190.31 <WSD>points</WSD> .	point.n.26:00
The wider Standard &amp; Poor 's 500 has itself advanced by 0.37 % ( 4.06 <WSD>points</WSD> ) to 1 106.41 points .	point.n.26:00
The wider Standard &amp; Poor 's 500 has itself advanced by 0.37 % ( 4.06 points ) to 1 106.41 <WSD>points</WSD> .	point.n.26:00
Frankly , the <WSD>market</WSD> is very calm , observes Mace Blicksilver of Marblehead Asset Management .	market.n.14:01
It remains within a <WSD>narrow</WSD> margin ; trading volumes have become very weak , and I think that this will remain the case until the end of the year .	narrow_margin.n.07:00
It remains within a narrow margin ; <WSD>trading</WSD> volumes have become very weak , and I think that this will remain the case until the end of the year .	trading.n.04:00
It remains within a narrow margin ; trading <WSD>volumes</WSD> have become very weak , and I think that this will remain the case until the end of the year .	volume.n.07:03
It remains within a narrow margin ; trading volumes have become very weak , and I think that this will remain the <WSD>case</WSD> until the end of the year .	case.n.09:00
It remains within a narrow margin ; trading volumes have become very weak , and I think that this will remain the case until the <WSD>end</WSD> of the year .	end.n.28:00
It remains within a narrow margin ; trading volumes have become very weak , and I think that this will remain the case until the end of the <WSD>year</WSD> .	year.n.28:01